1111111111111111111111111111111
10010000000C1000000000000000001
1000011111001000000C00000000001
100011000000100000000000000C001
1100000000011000000000000000001
1100000000010000000001111111111
10010000000C00000000000000000P1
1000011111000000000000000000001
1100011000000000000000000000001
1100000000010000000000000000011
1100000000010000000000000000011
11000000000100000111111C0000011
1000011111000000000000000000011
100011E000000000000C00000000011
11000C1100010001111110000000001
1100000000010000000000000000001
1100000000010000000000000000001
1100000000010000000000000000001
1100000000010000000000000000001
1111111111110000000000000000001
1100000000010000000000000000001
1100000000010000000000000000001
1100000000010000000000000000001
1100000000010000000000000000001
1100000000010000000000000000001
1100000000010000000000000000001
1100000000010011111111110000001
1100000000010000000000000000001
1111111111111111111111111111111